*G******
*S*******
*       *
* ** ** *
* *   * *
*   *   *
* *   * *
* ** ** *
*       *
*********